##########
#@..bc#..#
#.###.#c##
#.#c#.#..#
#.#.#.##.#
#...#....#
#.###.#.##
#.#c#.#.##
#b...e.c.#
##########