#########
#@......#
#.###.#.#
#.#c.#.#.
#.#.###.#
#.......#
#.###.#.#
#.#c.#.#.
#########