..b###
..##.#.####
.##.b###.b#
##b...c...#
#.c.@..#..#
###..###..#
..#..#...c#
.##.##.#.##
.#..c...##
.#...b.##
.#######