####################
#@..b...e..#.....c.#
#.###.###.#.###.#.#
#e#c.#...#.#b..#.#.#
#.#.#.###.#.###.#.#
#...#....b....#...##
#.###.###.#.###.#.#
#.#...#...#.#...#.#
#.#.###.###.#.###.#
#...b.....#.....c.#
#.###.###.#.###.#.#
#.#...#c..#.#...#.#
#.#.###.###.#.###.#
#...#.....b...#...##
#.###.###.#.###.#.#
#.#c.#...#.#c..#.#.#
#.#.#.###.#.###.#.#
#b.....e..#......c.#
####################